8
6
00000333
33330300
00000000
00033320
30333300
00003333
