8
6
03000302
03033330
00000000
33033033
30003003
30003003