8
6
00333300
00333300
30300303
30000003
00300302
00333300
